##############
#            #
#            #
#     /      #
#            #
#            #
#            #
#            #
#            #
#            #
#            #
#            #
#            #
#            #
##############