##################
#                #
#                #
#                #
#   ##########   #
#   #        #   #
#   #        #   #
#   ##########   #
#                #
#                #
#                #
#                #
#                #
#                #
#                #
#                #
#                #
#   ##########   #
#   #        #   #
#   #        #   #
#   #        #   #
#   #        #   #
#   #        #   #
#   #        #   #
#   #        #   #
#   #        #   #
#   #        #   #
#####        #####