#############
#     /     #
#           #
#           #
#           #
#           #
#           #
#           #
#           #
#           #
#           #
#           #
#           #
#           #
#           #
#           #
#           #
#           #
#           #
#           #
#           #
#           #
#           #
#           #
#           #
#           #
#           #
#           #
#           #
#           #
#           #
#           #
#           #
#           #
#           #
#           #
#           #
#           #
#############